{
	"world":
	{
		"background": "images/worlds/medieval/Background_01.png",
		"tile_set": "images/worlds/medieval/medieval-tileset.png",
		"frame_width": 64,
		"frame_height": 64,
		"frames_per_line": 1,
		"map":
		[
			[0, 0, 0, 0, 0, 0, 0, 0, 0, 0, 0, 0, 0, 0, 0, 0, 0, 0, 0, 0],
			[0, 0, 0, 0, 0, 0, 0, 0, 0, 0, 0, 0, 0, 0, 0, 0, 0, 0, 0, 0],
			[0, 0, 0, 0, 0, 0, 0, 0, 0, 0, 0, 0, 0, 0, 0, 0, 0, 0, 0, 0],
			[0, 0, 0, 0, 0, 0, 0, 0, 0, 0, 0, 0, 0, 0, 0, 0, 0, 0, 0, 0],
			[0, 0, 0, 0, 0, 0, 0, 0, 0, 0, 0, 0, 0, 0, 0, 0, 0, 0, 0, 0],
			[0, 0, 0, 0, 0, 0, 0, 0, 0, 0, 0, 0, 0, 0, 0, 0, 0, 0, 0, 0],
			[0, 0, 0, 0, 0, 0, 0, 0, 0, 0, 0, 0, 0, 0, 0, 0, 0, 0, 0, 0],
			[0, 0, 0, 0, 0, 0, 0, 0, 0, 0, 0, 0, 0, 0, 0, 0, 0, 0, 0, 0],
			[0, 0, 0, 0, 0, 0, 0, 0, 0, 0, 0, 0, 0, 0, 0, 0, 0, 0, 0, 0],
			[0, 0, 0, 0, 0, 0, 0, 0, 0, 0, 0, 0, 0, 0, 0, 0, 0, 0, 0, 0],
			[0, 0, 0, 0, 0, 0, 0, 0, 0, 0, 0, 0, 0, 0, 0, 0, 0, 0, 0, 0],
			[4, 2, 2, 2, 2, 2, 2, 2, 2, 2, 2, 2, 2, 2, 8, 0, 0, 0, 0, 0],
			[9, 6, 6, 6, 6, 6, 6, 6, 6, 6, 6, 6, 6, 6, 13, 0, 0, 0, 0, 0],
			[9, 6, 6, 6, 6, 6, 6, 6, 6, 6, 6, 6, 6, 6, 13, 0, 0, 0, 0, 0],
			[9, 6, 6, 6, 6, 6, 6, 6, 6, 6, 6, 6, 6, 6, 13, 0, 0, 0, 0, 0],
			[9, 6, 6, 6, 6, 6, 6, 6, 6, 6, 6, 6, 6, 6, 13, 0, 0, 0, 0, 0]
		],
		"items":[
			{
				"name": "coin",
				"displayName": "Coin",
				"sprite": "images/items/coin.png",
				"frame": 6,
				"position_x": 775,
				"position_y": 625,
				"count": 1
			}
		]
	}
}